      XXXX        XXXX    XXXXXXXX                XXXX    XXXX    XXXX    XXXX  
      XXXX        XXXX    XXXXXXXX                XXXX    XXXX    XXXX    XXXX  
XX    XXXXXXXX    XXXX    XXXA                    XXXX    XXXX    XXXX    XXXXXX
XX    XXXXXXXX    XXXX    XXXA                    XXXX    XXXX    XXXX    XXXXXX
XX    XXXXXXXX    XXXX    XXXA                    XXXX    XXXX    XXXX    XXXXXX
XX    XXXXXXXX    XXXX    XXXA                    XXXX    XXXX    XXXX    XXXXXX
XX                XXXX    XXXA    XXXX            XXXX    XXXX    XXXX    XXXXXX
XX                XXXX    XXXA    XXXX            XXXX    XXXX    XXXX    XXXXXX
XX                XXXX    XXXA    XXXX            XXXX    XXXX    XXXX    XXXXXX
XX                XXXX    XXXA    XXXX            XXXX    XXXX    XXXX    XXXXXX
XXXXXXXXXXXXXXXXXXXXXX    XXXA        XXXXXXXXXXXXXXXX    XXXX    XXXX    XXXXXX
XXXXXXXXXXXXXXXXXXXXXX    XXXA        XXXXXXXXXXXXXXXX    XXXX    XXXX    XXXXXX
XXXXXXXXXXXXXXXXXXXXXX    XXXA        XXXXXXXXXXXXXXXX    XXXX    XXXX    XXXXXX
XXXXXXXXXXXXXXXXXXXXXX    XXXA        XXXXXXXXXXXXXXXX    XXXX    XXXX    XXXXXX
                 XXXXX    XXXXXXXX                        XXXX    XXXX          
                 XXXXX    XXXXXXXX                        XXXX    XXXX          
                 XXXXX    XXXXXXXX                        XXXX    XXXX          
                 XXXXX    XXXXXXXX                        XXXX    XXXX          
XXXXXXXXXXXXXXXXXXXXXX    XXXXXXXX                        XXXX    XXXXXXXXXXXXXX
XXXXXXXXXXXXXXXXXXXXXX    XXXXXXXXXXXX        XXXX        XXXX    XXXXXXXXXXXXXX
XXXXXXXXXXXXXXXXXXXXXX    XXXXXXXXXXXX        XXXX        XXXX    XXXXXXXXXXXXXX
XXXXXXXXXXXXXXXXXXXXXX    XXXXXXXXXXXX        XXXX        XXXX    XXXXXXXXXXXXXX
                          XXXXXXXXXXXX        XXXX        XXXX                  
                          XXXXXXXX                        XXXX                  
                          XXXXXXXX                        XXXX                  
                          XXXXXXXX                        XXXX                  
  XXXXXXXXXXXXXXXXXXXXXXXXXXXXXXXX                XXXX        XXXXXXXXXXXXXXXX  
  XXXXXXXXXXXXXXXXXXXXXXXXXXXXXXXX                XXXX        XXXXXXXXXXXXXXXX  
  XXXXXXXXXXXXXXXXXXXXXXXXXXXXXXXX                XXXX        XXXXXXXXXXXXXXXX  
  XXXXXXXXXXXXXXXXXXXXXXXXXXXXXXXX                XXXX        XXXXXXXXXXXXXXXX  
  XXXXXXXXXXXA                                    XXXXXXXX                XXXX  
  XXXXXXXXXXXA                                    XXXXXXXX                XXXX  
  XXXXXXXXXXXA                                    XXXXXXXX                XXXX  
  XXXXXXXXXXXA                                    XXXXXXXX                XXXX  
  XXXXXXXXXXXA                                            XXXXXXXXXXXX    XXXX  
G XXXXXXXXXXXA                                            XXXXXXXXXXXX    XXXX  
  XXXXXXXXXXXA                                            XXXXXXXXXXXX    XXXX  
  XXXXXXXXXXXA       P                                    XXXXXXXXXXXX    XXXX  
  XXXXXXXXXXXA                XXXXXXXXXXXXXXXX    XXXX    XXXX            XXXX  
  XXXXXXXXXXXA                XXXXXXXXXXXXXXXX    XXXX    XXXX            XXXX  
  XXXXXXXXXXXA                XXXXXXXXXXXXXXXX    XXXX    XXXX            XXXX  
  XXXXXXXXXXXA                XXXXXXXXXXXXXXXX    XXXX    XXXX            XXXX  
  XXXX            P           XXXXXXXXXXXXXXXX    XXXX    XXXX        XXXXXXXX  
  XXXX                        XXXXXXXXXXXXXXXX    XXXX    XXXX        XXXXXXXX  
  XXXX                        XXXXXXXXXXXXXXXX    XXXX    XXXX        XXXXXXXX  
  XXXX                        XXXXXXXXXXXXXXXX    XXXX    XXXX        XXXXXXXX  
  XXXX    XXXX                                    XXXX    XXXXXXXX        XXXX  
  XXXX    XXXX                                    XXXX    XXXXXXXX        XXXX  
  XXXX    XXXX                                    XXXX    XXXXXXXX        XXXX  
  XXXX    XXXX                                    XXXX    XXXXXXXX        XXXX  
  XXXX    XXXX                XXXXXXXXXXXXXXXX    XXXX    XXXX            XXXX  
  XXXX    XXXX                XXXXXXXXXXXXXXXX    XXXX    XXXX            XXXX  
  XXXX    XXXX  P             XXXXXXXXXXXXXXXX    XXXX    XXXX            XXXX  
  XXXX    XXXX                XXXXXXXXXXXXXXXX    XXXX    XXXX            XXXX  
  XXXX    XXXX                XXXXXXXXXXXX        XXXX    XXXX    XXXX    XXXX  
  XXXX    XXXX                XXXXXXXXXXXX        XXXX    XXXX    XXXX    XXXX  
  XXXX    XXXX                XXXXXXXXXXXX        XXXX    XXXX    XXXX    XXXX  
  XXXX    XXXX             P  XXXXXXXXXXXX        XXXX    XXXX    XXXX    XXXX  
          XXXX                XXXXXXXX        XXXXXXXX                    XXXX  
          XXXX                XXXXXXXX        XXXXXXXX                    XXXX  
          XXXX                XXXXXXXX        XXXXXXXX                    XXXX  
          XXXX                XXXXXXXX        XXXXXXXX                    XXXX  
  XXXXXXXXXXXX    P           XXXX        XXXXXXXXXXXXXXXXXXXXXXXXXXXXXXXXXXXX  
  XXXXXXXXXXXX                XXXX        XXXXXXXXXXXXXXXXXXXXXXXXXXXXXXXXXXXX  
  XXXXXXXXXXXX                XXXX        XXXXXXXXXXXXXXXXXXXXXXXXXXXXXXXXXXXX  
  XXXXXXXXXXXX                XXXX        XXXXXXXXXXXXXXXXXXXXXXXXXXXXXXXXXXXX  
  XXXX                                XXXXXXXX                            XXXX  
  XXXX                                XXXXXXXX                            XXXX  
  XXXX                                XXXXXXXX                            XXXX  
  XXXX                                XXXXXXXX                            XXXX  
  XXXX    XXXXXXXXXXXX    XXXXXXXXXXXXXXXX                XXXX            XXXX  
  XXXX    XXXXXXXXXXXX    XXXXXXXXXXXXXXXX                XXXX            XXXX  
  XXXX    XXXXXXXXXXXX    XXXXXXXXXXXXXXXX                XXXX            XXXX  
  XXXX    XXXXXXXXXXXX    XXXXXXXXXXXXXXXX                XXXX            XXXX  
  XXXX        XXXXXXXX    XXXXXXXXXXXX                    XXXX            XXXX  
  XXXX        XXXXXXXX    XXXXXXXXXXXX                    XXXX            XXXX  
  XXXX        XXXXXXXX    XXXXXXXXXXXX                    XXXX            XXXX  
  XXXX        XXXXXXXX    XXXXXXXXXXXX                    XXXX            XXXX  
      XXXX        XXXX    XXXXXXXX                XXXX    XXXX    XXXX    XXXX  
      XXXX        XXXX    XXXXXXXX                XXXX    XXXX    XXXX    XXXX  